[console_scripts]
rtact = rtshell.rtact:main
rtcat = rtshell.rtcat:main
rtcheck = rtshell.rtcheck:main
rtcomp = rtshell.rtcomp:main
rtcon = rtshell.rtcon:main
rtconf = rtshell.rtconf:main
rtcryo = rtshell.rtcryo:main
rtdeact = rtshell.rtdeact:main
rtdel = rtshell.rtdel:main
rtdis = rtshell.rtdis:main
rtdoc = rtshell.rtdoc:main
rtexit = rtshell.rtexit:main
rtfind = rtshell.rtfind:main
rtfsm = rtshell.rtfsm:main
rtinject = rtshell.rtinject:main
rtlog = rtshell.rtlog:main
rtls = rtshell.rtls:main
rtmgr = rtshell.rtmgr:main
rtprint = rtshell.rtprint:main
rtpwd = rtshell.rtpwd:main
rtreset = rtshell.rtreset:main
rtresurrect = rtshell.rtresurrect:main
rtshell_post_install = rtshell.post_install:main
rtstart = rtshell.rtstart:main
rtstodot = rtshell.rtstodot:main
rtstop = rtshell.rtstop:main
rtteardown = rtshell.rtteardown:main
rtvlog = rtshell.rtvlog:main
rtwatch = rtshell.rtwatch:main

